............
..A.........
.......B....
..A.A.....B.
...AA.A.....
........A.A.    
....B.......
............
............
............
............